1111111111111111111111111111
10000000000000000C0000100001
1000C00000000000000000100P01
1011110111000011110001100001
10001000E1000000000000000001
1100111111000011111000000001
100000000000000000100000C001
1000000000000C00001111000001
1000C00000000000001C00000001
1111111111111111111111111111