111111111111111111111111111111111111111111111111111111111
100000010100110101010101000101011100110101001010101010101
100011111110010101010111100101011111011101010010101001011
1000111P1110001111111111101111010010010100101010110101001
100011101110000001110010101011010100100010100101010100111
100000001000000000010001111101011110010010101001000101111
100001000000000000010011010101010101001111111000101000101
111111111111111000010000101001001010101111001010100101011
10001101C001011000010001111101010100101001101001010110111
101001011100011010101010011101010001010101000100000011111
110101101000010000001010101001000101100011111100101010011
10C00110100001000C000111110001001010101010100011111110001
100010101001100110011100011000000111101010101011101001001
101010101100010100110000000101001100110101010010101001011
100001101001100001110000000101001010111111111111011111111
101010001000000001100011111101000110110101001010101110011
100011111000011100000000100001111101100100010010010001011
101010000000000110000000000001001100010101010010101010111
100000000111101111111111111111110101010101010001011101001
10111110001000001C011110000001001101010101010101001010101
10011E1000100110000110001111C1001100101010111100010100101
11001010001101C110011010000111010100010101101010010001111
11CC101000100100110010111101C1001101101111101001011101011
1CCC00111101000111100010010001001111110101010010110111111
110101010101010010101010101011010010111000010101010101011
101010101011010001010101010010101010100101001011010101001
101010111010101010101111110100100000101010010000011111111
100101101010011101010110100101010101011010111111000101111
100010110000111111101011010101001010100010101010010101111
110101001010010111100101010100100101001111111111010111111
111111010010110101010111001110101010100111111100101011111
110010010101010101001010101010010101010101010010101010111
111111111111111111111111111111111111111111111111111111111