11111111111111111111
10011000000000000001
100P1000000001000001
10111000000001000001
100000000000010C0001
11111111111111101111
100C1000C00001000001
10011100010001000001
10000100010000000001
10110000111111010101
101100001E0001110111
10C00000110100000001
11111111111111111111