11111111111111111111
10011000000000000001
100P100000C001000001
1011100000C001000001
100000000C0001000001
11111111111111101111
10001000000001000001
100111000100C1000001
10000100010000000001
10110000111111010101
101100001E0001110111
10010000110100000001
11111111111111111111